#Default SPB file associations
#ext  "default_program"  options

brd 	"%CDSROOT%\tools\pcb\bin\allegro.exe"
dra	"%CDSROOT%\tools\pcb\bin\allegro.exe"
mdd 	"%CDSROOT%\tools\pcb\bin\allegro.exe"
dpf 	"%CDSROOT%\tools\pcb\bin\allegro.exe"
pad	"%CDSROOT%\tools\pcb\bin\pad_designer.exe"
top 	"%CDSROOT%\tools\pcb\bin\sigxp.exe"    
mcm	"%CDSROOT%\tools\pcb\bin\apd.exe"
sip	"%CDSROOT%\tools\pcb\bin\cdnsip.exe"    
cpm	"%CDSROOT%\tools\fet\bin\projmgr.exe"    
sww	"%CDSROOT%\tools\pcb\bin\sigwave.exe"
cim 	"%CDSROOT%\tools\pcb\bin\sigwave.exe"
fds	"%CDSROOT%\tools\pcb\bin\sigwave.exe"
stl	"%CDSROOT%\tools\pspice\stmed.exe"
cir	"%CDSROOT%\tools\pspice\pspice.exe"
sim	"%CDSROOT%\tools\pspice\pspice.exe"
out	"%CDSROOT%\tools\capture\capture.exe"  	/dde
olb	"%CDSROOT%\tools\capture\capture.exe"
dsn	"%CDSROOT%\tools\capture\capture.exe"
opj	"%CDSROOT%\tools\capture\capture.exe"
max	"%CDSROOT%\tools\layout_plus\lsession.exe"
dsn 	"%CDSROOT%\tools\specctra\bin\specctra.exe"



  